0,0,0,1,1,1,1,1,1,1,1,1,
0,5,-1,11,11,-1,2,-1,-1,-1,-1,1,
0,0,0,1,1,1,1,1,1,1,-1,1,
1,4,-1,-1,7,-1,-1,-1,-1,1,-1,1,
1,-1,1,1,1,1,1,1,7,1,2,1,
1,-1,1,-1,7,-1,-1,1,-1,1,-1,1,
1,-1,1,-1,-1,7,-1,1,-1,1,-1,1,
1,-1,1,-1,1,1,1,1,7,1,3,1,
1,-1,1,7,-1,-1,-1,-1,-1,1,-1,1,
1,-1,1,1,1,1,1,1,1,1,-1,1,
1,-1,-1,6,-1,-1,-1,-1,-1,-1,-1,1,
1,1,1,1,1,1,1,1,1,1,1,1